10 10

OOXXXXXXXX
XOXXXOOOXX
XOOOOOXXXX
XOXOXOXOXX
XOXOXOXOXX
XOXOXOOOXX
XOXXXXXOOX
XOOOOOXXOX
XOXOXOOOOX
XXXXXXXXXX
