10 10

OOXXXXXXXX
OOOOOOOOOX
XOOOOOOOOX
XOOOOOOOOX
XOOOOOOOOX
XOOOOOOOOX
XOOOOOOOOX
XOOOOOOOOX
XOOOOOOOOX
XXXXXXXXXX
